▓▓▓▓▓▓▓▓▓▓▓▓▓▓▓▓▓▓▓▓▓▓▓
▓▓▓▓▓.............▓▓▓▓▓
▓▓▓▓▓.▓▓▓▓▓▓▓▓▓▓▓.▓▓▓▓▓
▓▓▓▓▓.▓▓▓▓▓*▓▓▓▓▓.▓▓▓▓▓
▓.....................▓
▓▓▓▓▓.▓▓▓▓▓.▓▓▓▓▓▓▓.▓▓▓
▓.....................▓
▓▓▓▓▓.▓▓▓▓▓.▓▓▓▓▓▓.▓▓▓▓
▓»....▓.........▓▓....▓
▓.▓▓▓▓▓▓▓▓▓.▓▓▓▓▓▓▓▓..▓
▓.....................▓
▓.▓▓▓▓▓▓▓▓▓.▓▓▓▓▓..▓▓▓▓
▓......▓...........▓▓▓▓                    
▓▓▓▓▓▓.▓▓▓▓.▓▓▓▓#▓▓▓▓▓▓
     ▓.▓  ▓-▓  ▓.▓
▓▓▓▓▓▓.▓ ▓...▓ ▓.▓▓▓▓▓▓
▓......▓ ▓.>.▓ ▓..?...▓
▓▓▓▓▓▓▓▓ ▓...▓ ▓▓▓▓▓▓▓▓
          ▓▓▓